month,invested,outlier,first,second,rest,total,number of clusters
1990-01,388,317,1626,10,0,1953,2
1990-02,366,323,1624,11,0,1958,2
1990-03,358,323,1598,0,0,1921,1
1990-04,362,315,1612,0,0,1927,1
1990-05,384,330,1621,0,0,1951,1
1990-06,338,328,1629,12,0,1969,2
1990-07,374,326,1655,0,0,1981,1
1990-08,370,319,1678,12,0,2009,2
1990-09,428,317,1678,10,0,2005,2
1990-10,468,322,1688,11,0,2021,2
1990-11,432,325,1699,13,0,2037,2
1990-12,436,335,1778,13,0,2126,2
1991-01,430,344,1793,12,0,2149,2
1991-02,408,345,1806,15,0,2166,2
1991-03,384,354,1743,15,0,2112,2
1991-04,408,350,1774,15,0,2139,2
1991-05,412,362,1783,14,0,2159,2
1991-06,384,364,1807,12,0,2183,2
1991-07,434,376,1829,11,0,2216,2
1991-08,402,382,1849,9,0,2240,2
1991-09,436,370,1836,13,0,2219,2
1991-10,422,380,1839,11,0,2230,2
1991-11,426,368,1856,9,0,2233,2
1991-12,504,382,1913,0,0,2295,1
1992-01,402,371,1917,0,0,2288,1
1992-02,408,383,1889,12,0,2284,2
1992-03,352,372,1848,12,0,2232,2
1992-04,460,375,1846,16,0,2237,2
1992-05,402,374,1870,0,0,2244,1
1992-06,374,385,1877,14,0,2276,2
1992-07,436,387,1886,15,7,2295,3
1992-08,444,381,1910,14,0,2305,2
1992-09,396,377,1891,11,0,2279,2
1992-10,464,370,1903,11,0,2284,2
1992-11,428,374,1910,10,0,2294,2
1992-12,376,397,1952,0,0,2349,1
1993-01,454,380,1951,12,0,2343,2
1993-02,460,395,1951,12,0,2358,2
1993-03,412,375,1908,10,0,2293,2
1993-04,464,382,1914,10,0,2306,2
1993-05,402,393,1909,12,0,2314,2
1993-06,398,381,1921,15,0,2317,2
1993-07,450,388,1931,15,0,2334,2
1993-08,448,390,1949,0,0,2339,1
1993-09,440,383,1904,15,0,2302,2
1993-10,356,378,1928,0,0,2306,1
1993-11,442,377,1924,14,0,2315,2
1993-12,486,397,1963,15,0,2375,2
1994-01,472,387,2003,0,0,2390,1
1994-02,456,384,2005,0,0,2389,1
1994-03,424,388,1927,16,0,2331,2
1994-04,454,362,1957,16,0,2335,2
1994-05,434,370,1971,14,0,2355,2
1994-06,402,388,1957,0,0,2345,1
1994-07,454,380,1970,15,0,2365,2
1994-08,444,389,1978,15,0,2382,2
1994-09,408,386,1950,13,0,2349,2
1994-10,412,393,1939,9,0,2341,2
1994-11,448,387,1937,13,0,2337,2
1994-12,480,377,1990,9,0,2376,2
1995-01,416,376,1992,14,0,2382,2
1995-02,466,388,1978,14,0,2380,2
1995-03,436,390,1961,0,0,2351,1
1995-04,412,392,1945,13,9,2359,3
1995-05,402,383,1972,13,10,2378,3
1995-06,406,381,1954,12,0,2347,2
1995-07,374,389,1971,12,0,2372,2
1995-08,364,401,1981,13,0,2395,2
1995-09,430,392,1990,0,0,2382,1
1995-10,456,389,1989,15,0,2393,2
1995-11,510,386,2015,15,0,2416,2
1995-12,476,430,2222,20,0,2672,2
1996-01,540,445,2222,19,0,2686,2
1996-02,532,442,2246,20,0,2708,2
1996-03,434,418,2076,0,0,2494,1
1996-04,464,413,2124,0,0,2537,1
1996-05,410,417,2143,0,0,2560,1
1996-06,526,405,2171,0,0,2576,1
1996-07,600,473,2394,0,0,2867,1
1996-08,494,471,2424,0,0,2895,1
1996-09,498,460,2348,0,0,2808,1
1996-10,582,480,2352,0,0,2832,1
1996-11,466,476,2385,0,0,2861,1
1996-12,546,478,2507,0,0,2985,1
1997-01,536,475,2516,0,0,2991,1
1997-02,590,478,2500,13,0,2991,2
1997-03,538,465,2382,0,0,2847,1
1997-04,578,477,2378,23,17,2895,3
1997-05,566,475,2390,22,17,2904,3
1997-06,576,499,2420,11,0,2930,2
1997-07,588,486,2467,12,0,2965,2
1997-08,560,494,2507,0,0,3001,1
1997-09,508,477,2461,0,0,2938,1
1997-10,548,483,2480,0,0,2963,1
1997-11,566,495,2484,0,0,2979,1
1997-12,648,513,2605,18,0,3136,2
1998-01,610,530,2636,21,0,3187,2
1998-02,596,536,2657,24,0,3217,2
1998-03,576,512,2640,28,0,3180,2
1998-04,548,502,2676,23,0,3201,2
1998-05,572,517,2676,27,0,3220,2
1998-06,618,503,2636,24,0,3163,2
1998-07,650,501,2667,0,0,3168,1
1998-08,826,513,2644,20,0,3177,2
1998-09,650,495,2621,0,0,3116,1
1998-10,670,509,2615,0,0,3124,1
1998-11,538,492,2654,0,0,3146,1
1998-12,662,494,2651,0,0,3145,1
1999-01,578,501,2655,0,0,3156,1
1999-02,594,509,2652,0,0,3161,1
1999-03,614,528,2789,0,0,3317,1
1999-04,728,530,2786,0,0,3316,1
1999-05,550,539,2775,0,0,3314,1
1999-06,574,517,2752,0,0,3269,1
1999-07,630,522,2775,0,0,3297,1
1999-08,592,539,2775,0,0,3314,1
1999-09,626,540,2772,0,0,3312,1
1999-10,682,542,2801,0,0,3343,1
1999-11,560,550,2841,0,0,3391,1
1999-12,588,566,3012,0,0,3578,1
2000-01,662,572,3037,0,0,3609,1
2000-02,582,596,3012,0,0,3608,1
2000-03,678,481,2580,0,0,3061,1
2000-04,704,488,2594,0,0,3082,1
2000-05,690,488,2622,0,0,3110,1
2000-06,574,490,2581,0,0,3071,1
2000-07,630,494,2608,0,0,3102,1
2000-08,628,482,2640,0,0,3122,1
2000-09,632,482,2563,0,0,3045,1
2000-10,662,492,2572,0,0,3064,1
2000-11,758,488,2608,0,0,3096,1
2000-12,804,571,3008,0,0,3579,1
2001-01,666,576,3011,0,0,3587,1
2001-02,728,576,3030,0,0,3606,1
2001-03,684,564,2890,7,0,3461,2
2001-04,656,572,2897,0,0,3469,1
2001-05,586,568,2902,9,0,3479,2
2001-06,686,566,2878,0,0,3444,1
2001-07,660,552,2897,0,0,3449,1
2001-08,666,547,2930,0,0,3477,1
2001-09,632,544,2833,0,0,3377,1
2001-10,588,550,2856,0,0,3406,1
2001-11,668,558,2884,0,0,3442,1
2001-12,548,588,2908,0,0,3496,1
2002-01,620,594,2924,0,0,3518,1
2002-02,672,570,2962,0,0,3532,1
2002-03,584,550,2875,0,0,3425,1
2002-04,658,555,2897,0,0,3452,1
2002-05,580,558,2927,0,0,3485,1
2002-06,718,561,2905,0,0,3466,1
2002-07,718,568,2930,0,0,3498,1
2002-08,624,575,2950,0,0,3525,1
2002-09,666,569,2876,0,0,3445,1
2002-10,608,557,2890,0,0,3447,1
2002-11,628,554,2898,0,0,3452,1
2002-12,690,556,2883,0,0,3439,1
2003-01,592,581,2865,0,0,3446,1
2003-02,662,574,2879,0,0,3453,1
2003-03,560,558,2802,0,0,3360,1
2003-04,620,543,2820,0,0,3363,1
2003-05,594,547,2834,0,0,3381,1
2003-06,596,552,2825,0,0,3377,1
2003-07,640,568,2837,0,0,3405,1
2003-08,600,562,2871,0,0,3433,1
2003-09,570,559,2823,0,0,3382,1
2003-10,600,562,2828,0,0,3390,1
2003-11,554,555,2865,0,0,3420,1
2003-12,608,572,2897,0,0,3469,1
2004-01,634,583,2913,0,0,3496,1
2004-02,644,589,2910,0,0,3499,1
2004-03,568,566,2856,0,0,3422,1
2004-04,688,583,2859,0,0,3442,1
2004-05,620,573,2904,0,0,3477,1
2004-06,600,579,2879,0,0,3458,1
2004-07,726,580,2900,0,0,3480,1
2004-08,638,583,2928,0,0,3511,1
2004-09,596,577,2894,0,0,3471,1
2004-10,660,564,2922,0,0,3486,1
2004-11,616,563,2936,0,0,3499,1
2004-12,534,583,2943,0,0,3526,1
2005-01,648,572,2958,0,0,3530,1
2005-02,636,581,2950,0,0,3531,1
2005-03,566,562,2850,27,0,3439,2
2005-04,684,554,2887,0,0,3441,1
2005-05,546,565,2886,0,0,3451,1
2005-06,620,546,2831,22,0,3399,2
2005-07,672,528,2870,0,0,3398,1
2005-08,572,547,2858,0,0,3405,1
2005-09,622,560,2769,0,0,3329,1
2005-10,590,555,2770,0,0,3325,1
2005-11,614,541,2787,0,0,3328,1
2005-12,570,529,2802,23,0,3354,2
2006-01,652,541,2798,21,0,3360,2
2006-02,568,539,2801,22,0,3362,2
2006-03,560,536,2744,0,0,3280,1
2006-04,608,532,2724,24,0,3280,2
2006-05,576,535,2727,24,0,3286,2
2006-06,390,515,2737,0,0,3252,1
2006-07,664,529,2704,25,0,3258,2
2006-08,596,528,2712,26,0,3266,2
2006-09,606,533,2635,23,0,3191,2
2006-10,596,534,2634,24,0,3192,2
2006-11,572,537,2643,22,0,3202,2
2006-12,592,527,2607,27,38,3199,4
2007-01,568,524,2650,27,0,3201,2
2007-02,612,525,2682,0,0,3207,1
2007-03,516,515,2587,0,0,3102,1
2007-04,568,513,2563,25,0,3101,2
2007-05,590,521,2552,24,0,3097,2
2007-06,452,500,2500,23,13,3036,3
2007-07,606,499,2540,0,0,3039,1
2007-08,632,492,2528,23,0,3043,2
2007-09,638,480,2495,23,0,2998,2
2007-10,622,484,2495,22,0,3001,2
2007-11,638,493,2488,23,0,3004,2
2007-12,550,506,2495,0,0,3001,1
2008-01,646,492,2522,0,0,3014,1
2008-02,596,499,2524,0,0,3023,1
2008-03,616,493,2475,0,0,2968,1
2008-04,574,501,2475,0,0,2976,1
2008-05,578,497,2460,24,0,2981,2
2008-06,626,489,2474,0,0,2963,1
2008-07,656,493,2490,0,0,2983,1
2008-08,568,498,2499,0,0,2997,1
2008-09,638,515,2426,0,0,2941,1
2008-10,666,497,2447,0,0,2944,1
2008-11,676,496,2462,0,0,2958,1
2008-12,510,420,2248,0,0,2668,1
2009-01,534,420,2268,0,0,2688,1
2009-02,576,417,2274,0,0,2691,1
2009-03,508,460,2475,0,0,2935,1
2009-04,586,472,2463,0,0,2935,1
2009-05,570,473,2469,0,0,2942,1
2009-06,548,475,2443,0,0,2918,1
2009-07,524,487,2455,0,0,2942,1
2009-08,498,488,2467,0,0,2955,1
2009-09,550,491,2429,0,0,2920,1
2009-10,604,487,2437,0,0,2924,1
2009-11,504,489,2422,19,0,2930,2
2009-12,340,438,2292,0,0,2730,1
2010-01,514,440,2304,0,0,2744,1
2010-02,516,439,2311,0,0,2750,1
2010-03,466,429,2207,22,0,2658,2
2010-04,472,431,2209,22,0,2662,2
2010-05,498,427,2223,22,0,2672,2
2010-06,554,427,2213,0,0,2640,1
2010-07,540,414,2219,20,0,2653,2
2010-08,496,416,2226,21,0,2663,2
2010-09,522,415,2181,18,0,2614,2
2010-10,474,418,2177,18,0,2613,2
2010-11,440,423,2186,17,0,2626,2
2010-12,124,451,2210,8,0,2669,2
2011-01,472,457,2223,0,0,2680,1
2011-02,428,457,2230,0,0,2687,1
2011-03,478,460,2385,0,0,2845,1
2011-04,522,466,2388,0,0,2854,1
2011-05,494,463,2397,0,0,2860,1
2011-06,448,463,2371,0,0,2834,1
2011-07,582,453,2398,0,0,2851,1
2011-08,662,459,2406,0,0,2865,1
2011-09,648,457,2373,0,0,2830,1
2011-10,626,469,2363,0,0,2832,1
2011-11,456,462,2383,0,0,2845,1
2011-12,188,433,2128,8,0,2569,2
2012-01,480,434,2140,9,0,2583,2
2012-02,472,437,2133,13,0,2583,2
2012-03,492,466,2303,9,0,2778,2
2012-04,526,447,2327,9,0,2783,2
2012-05,506,451,2326,9,0,2786,2
2012-06,556,464,2287,9,0,2760,2
2012-07,442,461,2298,9,0,2768,2
2012-08,486,459,2304,9,0,2772,2
2012-09,492,444,2295,8,6,2753,3
2012-10,490,450,2284,15,0,2749,2
2012-11,488,464,2276,10,0,2750,2
2012-12,404,446,2287,17,0,2750,2
2013-01,480,454,2282,15,0,2751,2
2013-02,474,448,2289,15,0,2752,2
2013-03,462,474,2198,8,0,2680,2
2013-04,476,458,2210,8,0,2676,2
2013-05,318,460,2208,9,0,2677,2
2013-06,442,453,2193,8,0,2654,2
2013-07,444,453,2193,9,0,2655,2
2013-08,438,457,2191,10,0,2658,2
2013-09,448,445,2156,7,0,2608,2
2013-10,492,444,2166,7,0,2617,2
2013-11,484,438,2180,8,0,2626,2
2013-12,190,440,2204,11,0,2655,2
2014-01,468,452,2201,9,0,2662,2
2014-02,466,444,2221,0,0,2665,1
2014-03,474,443,2167,10,0,2620,2
2014-04,470,443,2182,10,0,2635,2
2014-05,462,448,2195,0,0,2643,1
2014-06,424,457,2166,0,0,2623,1
2014-07,486,447,2184,0,0,2631,1
2014-08,444,436,2204,0,0,2640,1
2014-09,420,435,2149,19,0,2603,2
2014-10,536,424,2177,0,0,2601,1
2014-11,500,428,2170,6,0,2604,2
2014-12,476,425,2198,0,0,2623,1
2015-01,512,430,2210,0,0,2640,1
2015-02,484,436,2206,0,0,2642,1
2015-03,442,432,2169,7,0,2608,2
2015-04,444,440,2173,0,0,2613,1
2015-05,436,432,2186,0,0,2618,1
2015-06,446,423,2161,0,0,2584,1
2015-07,544,412,2173,0,0,2585,1
2015-08,430,420,2178,0,0,2598,1
2015-09,506,404,2134,0,0,2538,1
2015-10,428,414,2124,0,0,2538,1
2015-11,468,406,2136,0,0,2542,1
2015-12,462,428,2065,21,18,2532,3
2016-01,552,436,2056,22,19,2533,3
2016-02,446,428,2085,23,0,2536,2
2016-03,370,419,2053,22,0,2494,2
2016-04,432,414,2052,23,18,2507,3
2016-05,418,418,2078,16,0,2512,2
2016-06,146,416,2067,0,0,2483,1
2016-07,338,417,2068,0,0,2485,1
2016-08,410,422,2072,0,0,2494,1
2016-09,384,417,2022,15,0,2454,2
2016-10,414,420,2025,12,0,2457,2
2016-11,524,418,2039,14,0,2471,2
2016-12,280,411,2057,0,0,2468,1
2017-01,412,413,2057,0,0,2470,1
2017-02,458,412,2046,15,0,2473,2
2017-03,414,406,2005,0,0,2411,1
2017-04,424,406,2009,0,0,2415,1
2017-05,442,409,2017,0,0,2426,1
2017-06,340,404,1972,14,0,2390,2
2017-07,432,411,1962,15,14,2402,3
2017-08,418,402,1977,16,15,2410,3
2017-09,474,406,1950,15,12,2383,3
2017-10,444,417,1967,14,0,2398,2
2017-11,404,410,1978,13,11,2412,3
2017-12,408,417,2003,13,0,2433,2
2018-01,472,408,2029,0,0,2437,1
2018-02,454,409,2042,0,0,2451,1
2018-03,398,404,1976,11,0,2391,2
2018-04,454,410,1988,13,0,2411,2
2018-05,428,411,2018,0,0,2429,1
2018-06,446,399,1989,16,0,2404,2
2018-07,486,399,2016,0,0,2415,1
2018-08,432,410,2008,16,0,2434,2
2018-09,462,401,1994,0,0,2395,1
2018-10,506,396,2007,0,0,2403,1
2018-11,472,404,1996,16,0,2416,2
2018-12,500,413,1992,15,12,2432,3
2019-01,492,414,2011,15,0,2440,2
2019-02,424,408,2022,15,0,2445,2
2019-03,460,391,1953,16,0,2360,2
2019-04,450,388,1955,16,0,2359,2
2019-05,502,399,1948,15,0,2362,2
2019-06,450,396,1945,17,0,2358,2
2019-07,438,393,1957,17,0,2367,2
2019-08,456,411,1968,17,0,2396,2
2019-09,412,398,1954,11,0,2363,2
2019-10,332,389,1948,19,11,2367,3
2019-11,402,398,1948,20,9,2375,3
2019-12,374,400,1959,18,14,2391,3
2020-01,514,419,1946,18,13,2396,4
2020-02,370,411,1953,17,14,2395,4
2020-03,596,398,1893,16,17,2324,4
2020-04,460,392,1910,9,8,2319,3
2020-05,436,405,1896,9,9,2319,3
2020-06,372,386,1902,15,0,2303,2
2020-07,454,396,1888,15,0,2299,2
2020-08,402,395,1889,15,0,2299,2
2020-09,414,380,1879,13,0,2272,2
2020-10,486,377,1881,12,0,2270,2
2020-11,396,378,1878,14,0,2270,2
2020-12,406,394,1871,11,0,2276,2
2021-01,326,384,1880,10,0,2274,2
2021-02,466,385,1877,11,0,2273,2
2021-03,430,373,1821,12,0,2206,2
2021-04,396,363,1825,17,0,2205,2
2021-05,412,365,1822,17,0,2204,2
2021-06,360,365,1791,15,0,2171,2
2021-07,432,365,1794,7,0,2166,2
2021-08,424,362,1798,8,0,2168,2
2021-09,440,355,1773,16,0,2144,2
2021-10,396,360,1771,7,6,2144,3
2021-11,412,359,1771,13,0,2143,2
2021-12,448,351,1804,0,0,2155,1
2022-01,468,357,1798,0,0,2155,1
2022-02,404,355,1800,0,0,2155,1
2022-03,396,353,1731,0,0,2084,1
2022-04,442,352,1730,0,0,2082,1
2022-05,374,347,1734,0,0,2081,1
2022-06,430,348,1714,0,0,2062,1
2022-07,344,322,1589,0,0,1911,1
2022-08,320,306,1539,0,0,1845,1
