month,invested,outlier,first,second,rest,total,number of clusters
1990-01,464,196,54,38,1665,1953,417
1990-02,440,196,38,28,1696,1958,433
1990-03,486,192,45,31,1653,1921,434
1990-04,496,193,37,35,1662,1927,429
1990-05,446,195,51,41,1664,1951,425
1990-06,468,197,51,34,1687,1969,432
1990-07,506,198,40,30,1713,1981,432
1990-08,456,201,32,30,1746,2009,444
1990-09,448,201,35,30,1739,2005,454
1990-10,492,202,43,30,1746,2021,453
1990-11,496,204,39,35,1759,2037,477
1990-12,508,213,35,28,1850,2126,496
1991-01,492,215,30,26,1878,2149,497
1991-02,490,217,43,27,1879,2166,477
1991-03,484,212,38,32,1830,2112,452
1991-04,506,214,43,38,1844,2139,453
1991-05,490,215,40,31,1873,2159,471
1991-06,496,218,40,39,1886,2183,472
1991-07,506,222,45,33,1916,2216,456
1991-08,474,224,46,31,1939,2240,476
1991-09,524,222,40,36,1921,2219,479
1991-10,516,223,37,30,1940,2230,464
1991-11,486,224,34,31,1944,2233,453
1991-12,574,230,49,39,1977,2295,457
1992-01,502,229,40,38,1981,2288,463
1992-02,530,229,48,38,1969,2284,451
1992-03,476,224,29,27,1952,2232,480
1992-04,544,224,34,31,1948,2237,470
1992-05,526,225,52,43,1924,2244,486
1992-06,468,228,39,32,1977,2276,485
1992-07,570,230,45,33,1987,2295,490
1992-08,520,231,35,34,2005,2305,501
1992-09,528,228,44,41,1966,2279,482
1992-10,550,229,34,30,1991,2284,476
1992-11,538,230,41,39,1984,2294,472
1992-12,524,235,38,30,2046,2349,494
1993-01,562,235,44,30,2034,2343,477
1993-02,588,236,39,31,2052,2358,505
1993-03,538,230,46,45,1972,2293,469
1993-04,580,231,36,34,2005,2306,500
1993-05,510,232,48,33,2001,2314,473
1993-06,510,232,47,40,1998,2317,481
1993-07,512,234,44,38,2018,2334,489
1993-08,544,234,37,32,2036,2339,502
1993-09,526,231,34,31,2006,2302,507
1993-10,542,231,44,32,1999,2306,516
1993-11,542,232,46,31,2006,2315,514
1993-12,546,238,46,40,2051,2375,522
1994-01,594,239,42,32,2077,2390,536
1994-02,598,239,59,46,2045,2389,542
1994-03,572,233,33,29,2036,2331,538
1994-04,578,234,31,29,2041,2335,535
1994-05,542,236,41,28,2050,2355,559
1994-06,516,235,44,38,2028,2345,558
1994-07,622,237,47,27,2054,2365,547
1994-08,504,239,51,42,2050,2382,572
1994-09,540,235,46,26,2042,2349,549
1994-10,506,234,43,27,2037,2341,551
1994-11,542,234,52,28,2023,2337,516
1994-12,560,238,47,38,2053,2376,566
1995-01,570,239,53,31,2059,2382,558
1995-02,570,238,40,31,2071,2380,561
1995-03,514,235,35,34,2047,2351,522
1995-04,560,236,41,33,2049,2359,528
1995-05,542,238,40,39,2061,2378,514
1995-06,478,235,45,35,2032,2347,516
1995-07,510,237,37,32,2066,2372,514
1995-08,490,240,44,34,2077,2395,508
1995-09,548,239,38,32,2073,2382,504
1995-10,588,240,39,38,2076,2393,522
1995-11,604,242,47,36,2091,2416,541
1995-12,644,268,34,31,2339,2672,563
1996-01,650,269,33,30,2354,2686,553
1996-02,624,271,37,29,2371,2708,574
1996-03,596,250,51,34,2159,2494,544
1996-04,572,253,59,36,2189,2537,569
1996-05,538,256,54,50,2200,2560,566
1996-06,618,258,49,43,2226,2576,582
1996-07,728,287,50,33,2497,2867,635
1996-08,612,290,46,39,2520,2895,646
1996-09,644,281,40,37,2450,2808,623
1996-10,690,284,42,41,2465,2832,621
1996-11,654,286,39,30,2506,2861,648
1996-12,716,299,35,34,2617,2985,637
1997-01,664,299,52,35,2605,2991,638
1997-02,746,299,49,32,2611,2991,627
1997-03,716,285,48,41,2473,2847,584
1997-04,676,290,40,36,2529,2895,589
1997-05,706,291,32,30,2551,2904,599
1997-06,674,293,33,32,2572,2930,654
1997-07,746,297,54,37,2577,2965,645
1997-08,714,300,43,37,2621,3001,645
1997-09,678,294,49,41,2554,2938,641
1997-10,666,297,47,46,2573,2963,651
1997-11,676,298,40,36,2605,2979,627
1997-12,708,314,57,51,2714,3136,677
1998-01,740,319,50,40,2778,3187,676
1998-02,750,322,46,38,2811,3217,704
1998-03,674,318,43,41,2778,3180,697
1998-04,688,320,39,38,2804,3201,681
1998-05,740,322,47,42,2809,3220,674
1998-06,728,316,34,31,2782,3163,693
1998-07,780,317,34,33,2784,3168,712
1998-08,866,318,36,30,2793,3177,681
1998-09,796,312,47,36,2721,3116,702
1998-10,810,313,42,40,2729,3124,703
1998-11,704,315,38,35,2758,3146,706
1998-12,760,315,30,28,2772,3145,660
1999-01,666,316,47,36,2757,3156,649
1999-02,714,316,48,33,2764,3161,689
1999-03,808,332,34,32,2919,3317,728
1999-04,862,332,49,31,2904,3316,719
1999-05,678,332,39,37,2906,3314,688
1999-06,784,327,43,41,2858,3269,687
1999-07,746,330,48,47,2872,3297,684
1999-08,770,332,46,35,2901,3314,686
1999-09,786,332,37,36,2907,3312,699
1999-10,780,335,39,34,2935,3343,715
1999-11,692,339,43,40,2969,3391,719
1999-12,774,358,54,47,3119,3578,728
2000-01,770,361,53,35,3160,3609,737
2000-02,670,361,56,42,3149,3608,711
2000-03,806,306,44,43,2668,3061,685
2000-04,782,309,49,40,2684,3082,671
2000-05,760,311,42,40,2717,3110,699
2000-06,714,307,45,42,2677,3071,678
2000-07,754,311,57,42,2692,3102,690
2000-08,690,313,48,39,2722,3122,715
2000-09,746,305,39,37,2664,3045,694
2000-10,792,307,38,34,2685,3064,731
2000-11,768,310,39,36,2711,3096,746
2000-12,880,358,70,56,3095,3579,743
2001-01,726,359,55,42,3131,3587,766
2001-02,854,361,67,55,3123,3606,753
2001-03,836,346,49,46,3020,3461,721
2001-04,774,347,46,40,3036,3469,737
2001-05,742,348,42,41,3048,3479,745
2001-06,734,345,46,45,3008,3444,721
2001-07,814,345,52,39,3013,3449,703
2001-08,766,347,58,46,3026,3477,709
2001-09,814,338,45,38,2956,3377,671
2001-10,728,341,55,48,2962,3406,689
2001-11,812,345,43,39,3015,3442,695
2001-12,618,350,46,38,3062,3496,722
2002-01,824,352,54,42,3070,3518,719
2002-02,830,354,48,46,3084,3532,734
2002-03,762,343,43,35,3004,3425,720
2002-04,884,346,56,51,2999,3452,709
2002-05,758,349,40,36,3060,3485,730
2002-06,850,347,44,36,3039,3466,711
2002-07,770,350,42,34,3072,3498,730
2002-08,788,353,33,31,3108,3525,754
2002-09,866,345,43,42,3015,3445,738
2002-10,752,345,39,32,3031,3447,723
2002-11,766,346,37,33,3036,3452,726
2002-12,828,344,55,33,3007,3439,715
2003-01,702,345,51,40,3010,3446,714
2003-02,798,346,38,35,3034,3453,707
2003-03,734,336,41,38,2945,3360,712
2003-04,694,337,55,45,2926,3363,685
2003-05,718,338,50,47,2946,3381,702
2003-06,704,338,51,36,2952,3377,684
2003-07,802,341,40,37,2987,3405,689
2003-08,680,344,64,45,2980,3433,688
2003-09,698,339,49,45,2949,3382,662
2003-10,754,339,55,41,2955,3390,677
2003-11,762,342,45,44,2989,3420,671
2003-12,724,347,59,46,3017,3469,697
2004-01,794,350,54,45,3047,3496,689
2004-02,776,350,51,45,3053,3499,684
2004-03,714,343,62,55,2962,3422,668
2004-04,856,345,53,51,2993,3442,670
2004-05,690,348,50,47,3032,3477,693
2004-06,738,346,59,42,3011,3458,678
2004-07,838,348,64,45,3023,3480,712
2004-08,794,351,75,48,3037,3511,743
2004-09,800,347,83,56,2985,3471,689
2004-10,776,349,69,56,3012,3486,692
2004-11,686,350,50,49,3050,3499,703
2004-12,664,353,51,46,3076,3526,721
2005-01,828,353,55,37,3085,3530,723
2005-02,778,353,52,42,3084,3531,721
2005-03,750,344,51,47,2997,3439,698
2005-04,810,344,60,44,2993,3441,707
2005-05,720,345,63,45,2998,3451,702
2005-06,712,340,49,43,2967,3399,716
2005-07,802,340,58,45,2955,3398,718
2005-08,684,341,61,47,2956,3405,715
2005-09,718,333,49,45,2902,3329,683
2005-10,770,333,63,42,2887,3325,655
2005-11,746,333,54,46,2895,3328,669
2005-12,736,336,95,39,2884,3354,693
2006-01,774,336,76,43,2905,3360,679
2006-02,704,337,76,45,2904,3362,667
2006-03,634,328,87,40,2825,3280,649
2006-04,722,328,102,51,2799,3280,643
2006-05,710,329,72,48,2837,3286,647
2006-06,516,326,74,51,2801,3252,647
2006-07,758,326,67,60,2805,3258,660
2006-08,706,327,68,54,2817,3266,668
2006-09,728,319,45,43,2784,3191,642
2006-10,738,320,46,45,2781,3192,648
2006-11,688,321,54,45,2782,3202,642
2006-12,706,320,40,39,2800,3199,654
2007-01,710,320,57,44,2780,3201,655
2007-02,816,321,49,48,2789,3207,660
2007-03,704,311,53,49,2689,3102,659
2007-04,698,310,84,42,2665,3101,642
2007-05,672,310,48,42,2697,3097,637
2007-06,548,304,68,46,2618,3036,610
2007-07,674,304,45,42,2648,3039,619
2007-08,694,305,55,40,2643,3043,615
2007-09,700,300,46,43,2609,2998,623
2007-10,760,300,67,39,2595,3001,616
2007-11,738,301,43,40,2620,3004,610
2007-12,684,300,56,41,2604,3001,612
2008-01,780,302,45,40,2627,3014,611
2008-02,694,303,48,44,2628,3023,612
2008-03,758,297,50,44,2577,2968,633
2008-04,696,298,47,35,2596,2976,612
2008-05,660,298,57,32,2594,2981,622
2008-06,696,296,46,44,2577,2963,629
2008-07,728,298,60,40,2585,2983,624
2008-08,678,299,46,39,2613,2997,624
2008-09,696,294,51,34,2562,2941,597
2008-10,748,295,54,42,2553,2944,617
2008-11,792,296,45,38,2579,2958,645
2008-12,598,267,37,36,2328,2668,622
2009-01,682,269,31,26,2362,2688,611
2009-02,688,269,27,23,2372,2691,616
2009-03,638,294,40,30,2571,2935,622
2009-04,662,294,38,35,2568,2935,628
2009-05,654,295,41,40,2566,2942,620
2009-06,678,292,44,43,2539,2918,598
2009-07,598,295,35,33,2579,2942,609
2009-08,642,296,44,40,2575,2955,615
2009-09,656,292,39,34,2555,2920,596
2009-10,714,293,44,38,2549,2924,597
2009-11,634,293,45,35,2557,2930,625
2009-12,562,273,43,38,2376,2730,582
2010-01,644,275,46,31,2392,2744,587
2010-02,612,275,46,31,2398,2750,586
2010-03,548,266,36,31,2325,2658,571
2010-04,554,267,33,30,2332,2662,561
2010-05,574,268,36,29,2339,2672,567
2010-06,648,264,39,35,2302,2640,560
2010-07,664,266,30,27,2330,2653,586
2010-08,620,267,30,28,2338,2663,598
2010-09,574,262,37,30,2285,2614,579
2010-10,614,262,33,30,2288,2613,574
2010-11,528,263,42,27,2294,2626,572
2010-12,302,267,41,27,2334,2669,572
2011-01,616,268,35,29,2348,2680,584
2011-02,538,269,33,26,2359,2687,582
2011-03,682,285,49,40,2471,2845,607
2011-04,632,286,62,34,2472,2854,603
2011-05,648,286,49,38,2487,2860,610
2011-06,580,283,77,46,2428,2834,604
2011-07,660,285,48,39,2479,2851,606
2011-08,738,286,58,40,2481,2865,621
2011-09,716,283,75,36,2436,2830,583
2011-10,640,283,67,38,2444,2832,595
2011-11,530,284,49,41,2471,2845,598
2011-12,198,257,37,36,2239,2569,520
2012-01,590,259,39,35,2250,2583,524
2012-02,584,259,48,41,2235,2583,531
2012-03,564,278,61,36,2403,2778,564
2012-04,642,279,69,50,2385,2783,551
2012-05,638,279,48,40,2419,2786,554
2012-06,692,276,59,51,2374,2760,548
2012-07,540,277,59,35,2397,2768,563
2012-08,556,278,45,44,2405,2772,568
2012-09,620,276,56,40,2381,2753,520
2012-10,646,275,51,48,2375,2749,518
2012-11,648,275,76,41,2358,2750,539
2012-12,502,275,54,43,2378,2750,529
2013-01,634,275,73,48,2355,2751,534
2013-02,588,276,65,37,2374,2752,529
2013-03,548,268,58,40,2314,2680,521
2013-04,588,268,49,43,2316,2676,511
2013-05,330,267,79,44,2287,2677,520
2013-06,538,266,52,40,2296,2654,488
2013-07,528,266,48,38,2303,2655,505
2013-08,568,266,54,35,2303,2658,506
2013-09,506,261,49,47,2251,2608,512
2013-10,534,262,47,42,2266,2617,516
2013-11,632,263,39,37,2287,2626,515
2013-12,322,266,44,36,2309,2655,496
2014-01,590,267,63,37,2295,2662,479
2014-02,610,267,83,37,2278,2665,473
2014-03,604,262,92,32,2234,2620,477
2014-04,576,264,57,42,2272,2635,492
2014-05,604,265,75,37,2266,2643,494
2014-06,570,263,61,42,2257,2623,505
2014-07,604,262,76,39,2254,2631,510
2014-08,514,264,66,46,2264,2640,512
2014-09,562,261,46,42,2254,2603,480
2014-10,620,260,51,43,2247,2601,483
2014-11,626,261,50,39,2254,2604,489
2014-12,594,263,48,42,2270,2623,489
2015-01,602,264,41,38,2297,2640,500
2015-02,544,265,49,40,2288,2642,489
2015-03,510,261,64,46,2237,2608,494
2015-04,510,262,70,42,2239,2613,498
2015-05,544,262,70,42,2244,2618,498
2015-06,550,259,54,48,2223,2584,505
2015-07,574,259,61,35,2230,2585,487
2015-08,520,260,55,35,2248,2598,503
2015-09,586,254,57,46,2181,2538,455
2015-10,554,254,60,37,2187,2538,465
2015-11,582,255,48,39,2200,2542,479
2015-12,542,254,62,56,2160,2532,447
2016-01,606,254,61,47,2171,2533,440
2016-02,494,254,88,44,2150,2536,452
2016-03,462,250,88,41,2115,2494,450
2016-04,542,251,78,55,2123,2507,456
2016-05,526,252,71,45,2144,2512,458
2016-06,334,249,91,46,2097,2483,436
2016-07,386,249,58,46,2132,2485,434
2016-08,522,250,63,43,2138,2494,441
2016-09,468,246,59,36,2113,2454,416
2016-10,554,246,54,52,2105,2457,414
2016-11,610,247,74,51,2099,2471,406
2016-12,454,247,50,43,2128,2468,426
2017-01,496,247,60,53,2110,2470,419
2017-02,540,248,47,44,2134,2473,441
2017-03,560,241,82,41,2047,2411,429
2017-04,512,242,74,57,2042,2415,426
2017-05,534,243,57,41,2085,2426,429
2017-06,366,239,51,44,2056,2390,438
2017-07,542,241,48,45,2068,2402,427
2017-08,506,241,69,39,2061,2410,428
2017-09,522,239,56,45,2043,2383,419
2017-10,504,240,53,38,2067,2398,423
2017-11,524,242,53,40,2077,2412,424
2017-12,504,244,50,48,2091,2433,458
2018-01,518,244,57,51,2085,2437,438
2018-02,538,245,79,49,2078,2451,424
2018-03,514,239,79,53,2020,2391,466
2018-04,560,241,70,66,2034,2411,465
2018-05,564,243,101,40,2045,2429,463
2018-06,492,241,53,37,2073,2404,435
2018-07,574,242,37,36,2100,2415,442
2018-08,512,244,37,35,2118,2434,446
2018-09,524,240,45,38,2072,2395,441
2018-10,616,241,52,50,2060,2403,442
2018-11,564,242,51,39,2084,2416,447
2018-12,578,244,61,40,2087,2432,425
2019-01,588,244,46,39,2111,2440,429
2019-02,508,245,68,50,2082,2445,429
2019-03,534,236,74,73,1977,2360,439
2019-04,532,236,68,62,1993,2359,431
2019-05,540,237,69,60,1996,2362,435
2019-06,524,236,62,55,2005,2358,456
2019-07,508,237,55,39,2036,2367,417
2019-08,522,240,68,48,2040,2396,441
2019-09,520,237,53,44,2029,2363,464
2019-10,498,237,44,43,2043,2367,453
2019-11,490,238,45,41,2051,2375,461
2019-12,444,239,50,46,2056,2391,439
2020-01,516,240,50,48,2058,2396,437
2020-02,522,240,55,51,2049,2395,439
2020-03,626,233,70,47,1974,2324,413
2020-04,512,232,69,61,1957,2319,419
2020-05,496,232,65,60,1962,2319,410
2020-06,462,231,65,56,1951,2303,414
2020-07,498,229,62,57,1951,2299,405
2020-08,506,230,54,39,1976,2299,409
2020-09,508,228,63,51,1930,2272,417
2020-10,534,227,51,39,1953,2270,407
2020-11,452,227,72,37,1934,2270,412
2020-12,452,228,49,45,1954,2276,370
2021-01,324,228,71,53,1922,2274,381
2021-02,558,228,62,47,1936,2273,378
2021-03,490,221,63,53,1869,2206,370
2021-04,462,221,68,58,1858,2205,363
2021-05,484,221,58,50,1875,2204,370
2021-06,458,216,66,41,1848,2171,378
2021-07,492,217,64,44,1841,2166,389
2021-08,518,217,44,42,1865,2168,393
2021-09,528,215,56,50,1823,2144,394
2021-10,506,215,63,53,1813,2144,374
2021-11,488,215,64,50,1814,2143,382
2021-12,524,216,68,43,1828,2155,387
2022-01,574,216,73,51,1815,2155,387
2022-02,512,216,93,50,1796,2155,394
2022-03,430,209,49,38,1788,2084,419
2022-04,514,209,54,38,1781,2082,412
2022-05,290,208,83,36,1754,2081,406
2022-06,462,207,83,35,1737,2062,364
2022-07,408,191,53,41,1626,1911,341
2022-08,398,185,87,38,1535,1845,320
