month,invested,outlier,first,second,rest,total,number of clusters
1990-01,70,1077,158,114,604,1953,31
1990-02,60,1050,136,102,670,1958,37
1990-03,102,1039,142,88,652,1921,35
1990-04,90,1031,202,92,602,1927,35
1990-05,94,1076,164,118,593,1951,35
1990-06,78,1055,157,128,629,1969,32
1990-07,92,1053,217,160,551,1981,37
1990-08,74,1064,121,112,712,2009,36
1990-09,110,1056,132,110,707,2005,37
1990-10,150,1115,133,120,653,2021,35
1990-11,100,1113,171,137,616,2037,35
1990-12,56,1123,167,108,728,2126,37
1991-01,78,1154,169,106,720,2149,32
1991-02,76,1190,190,136,650,2166,33
1991-03,54,1187,192,157,576,2112,34
1991-04,104,1138,182,106,713,2139,32
1991-05,102,1174,192,169,624,2159,36
1991-06,70,1197,183,157,646,2183,36
1991-07,80,1193,186,125,712,2216,38
1991-08,24,1217,237,114,672,2240,35
1991-09,72,1180,211,100,728,2219,36
1991-10,34,1168,157,135,770,2230,35
1991-11,88,1220,232,182,599,2233,37
1991-12,24,1280,218,179,618,2295,36
1992-01,56,1284,222,118,664,2288,37
1992-02,52,1262,177,123,722,2284,34
1992-03,50,1222,174,131,705,2232,32
1992-04,88,1238,276,168,555,2237,35
1992-05,128,1210,190,119,725,2244,36
1992-06,26,1293,197,180,606,2276,30
1992-07,102,1284,253,156,602,2295,32
1992-08,112,1258,262,195,590,2305,31
1992-09,100,1254,216,163,646,2279,35
1992-10,90,1248,190,153,693,2284,33
1992-11,78,1286,240,192,576,2294,30
1992-12,106,1367,234,175,573,2349,34
1993-01,78,1308,257,120,658,2343,35
1993-02,74,1336,229,177,616,2358,31
1993-03,98,1249,210,183,651,2293,30
1993-04,112,1264,177,148,717,2306,29
1993-05,52,1289,236,180,609,2314,32
1993-06,82,1258,169,160,730,2317,32
1993-07,12,1314,239,198,583,2334,32
1993-08,76,1288,208,130,713,2339,34
1993-09,80,1270,239,194,599,2302,33
1993-10,82,1229,225,172,680,2306,32
1993-11,84,1227,290,110,688,2315,38
1993-12,10,1269,232,165,709,2375,34
1994-01,96,1292,257,134,707,2390,38
1994-02,104,1321,210,146,712,2389,36
1994-03,118,1269,216,126,720,2331,36
1994-04,116,1276,225,129,705,2335,35
1994-05,64,1309,221,211,614,2355,35
1994-06,82,1278,239,207,621,2345,35
1994-07,128,1262,217,124,762,2365,39
1994-08,102,1298,269,99,716,2382,39
1994-09,106,1301,217,135,696,2349,34
1994-10,106,1277,239,98,727,2341,38
1994-11,82,1299,172,140,726,2337,37
1994-12,62,1271,270,140,695,2376,35
1995-01,90,1290,257,134,701,2382,38
1995-02,92,1278,245,148,709,2380,37
1995-03,102,1300,213,127,711,2351,33
1995-04,70,1267,248,131,713,2359,36
1995-05,74,1287,223,213,655,2378,34
1995-06,82,1268,226,190,663,2347,36
1995-07,22,1284,235,149,704,2372,35
1995-08,78,1310,198,150,737,2395,34
1995-09,102,1301,198,189,694,2382,41
1995-10,130,1281,245,143,724,2393,36
1995-11,106,1342,189,171,714,2416,34
1995-12,112,1489,268,184,731,2672,33
1996-01,86,1503,227,201,755,2686,32
1996-02,76,1491,219,177,821,2708,35
1996-03,96,1356,260,169,709,2494,33
1996-04,62,1421,243,228,645,2537,32
1996-05,66,1440,221,188,711,2560,30
1996-06,110,1475,372,131,598,2576,33
1996-07,138,1644,260,154,809,2867,36
1996-08,24,1643,294,168,790,2895,36
1996-09,110,1591,270,219,728,2808,35
1996-10,120,1582,296,139,815,2832,34
1996-11,126,1645,319,187,710,2861,37
1996-12,114,1688,315,144,838,2985,33
1997-01,86,1683,318,208,782,2991,36
1997-02,108,1688,383,156,764,2991,38
1997-03,132,1574,251,196,826,2847,35
1997-04,54,1674,291,169,761,2895,34
1997-05,112,1623,237,184,860,2904,36
1997-06,120,1672,352,128,778,2930,32
1997-07,96,1679,344,151,791,2965,35
1997-08,92,1705,334,198,764,3001,38
1997-09,130,1671,257,175,835,2938,31
1997-10,108,1710,309,197,747,2963,33
1997-11,122,1704,237,196,842,2979,34
1997-12,50,1794,307,238,797,3136,31
1998-01,84,1841,278,216,852,3187,33
1998-02,72,1882,284,182,869,3217,32
1998-03,34,1862,244,180,894,3180,31
1998-04,76,1897,370,236,698,3201,30
1998-05,54,1920,366,243,691,3220,31
1998-06,80,1842,206,192,923,3163,33
1998-07,106,1847,225,178,918,3168,31
1998-08,206,1865,278,160,874,3177,32
1998-09,202,1770,286,242,818,3116,33
1998-10,148,1816,244,185,879,3124,36
1998-11,52,1817,258,178,893,3146,38
1998-12,82,1828,261,148,908,3145,34
1999-01,54,1866,260,146,884,3156,34
1999-02,56,1863,217,192,889,3161,33
1999-03,124,1956,253,184,924,3317,37
1999-04,102,1975,285,189,867,3316,36
1999-05,76,1954,290,193,877,3314,34
1999-06,112,1933,281,259,796,3269,30
1999-07,52,1919,223,166,989,3297,36
1999-08,54,1978,231,197,908,3314,28
1999-09,112,1952,325,209,826,3312,35
1999-10,110,1976,264,178,925,3343,35
1999-11,34,2012,270,224,885,3391,36
1999-12,46,2116,259,253,950,3578,31
2000-01,64,2099,256,213,1041,3609,34
2000-02,32,2099,289,218,1002,3608,31
2000-03,164,1742,279,250,790,3061,33
2000-04,154,1783,283,233,783,3082,37
2000-05,82,1783,221,176,930,3110,33
2000-06,128,1712,280,222,857,3071,36
2000-07,178,1741,294,241,826,3102,38
2000-08,112,1737,274,212,899,3122,38
2000-09,196,1712,290,235,808,3045,34
2000-10,176,1741,272,234,817,3064,34
2000-11,110,1758,312,200,826,3096,34
2000-12,134,2096,281,180,1022,3579,34
2001-01,40,2124,261,245,957,3587,35
2001-02,64,2133,405,259,809,3606,31
2001-03,130,2020,300,165,976,3461,34
2001-04,94,2052,364,183,870,3469,35
2001-05,10,2094,330,251,804,3479,32
2001-06,90,2041,423,195,785,3444,35
2001-07,104,2000,310,171,968,3449,35
2001-08,86,2027,342,168,940,3477,31
2001-09,110,1983,278,163,953,3377,36
2001-10,52,2026,252,188,940,3406,35
2001-11,92,2055,405,246,736,3442,30
2001-12,58,2049,260,237,950,3496,35
2002-01,78,2074,317,159,968,3518,34
2002-02,70,2077,335,265,855,3532,32
2002-03,92,1995,312,219,899,3425,38
2002-04,84,2061,388,270,733,3452,35
2002-05,82,2070,229,190,996,3485,37
2002-06,96,2058,322,175,911,3466,31
2002-07,28,2066,343,277,812,3498,35
2002-08,50,2059,228,165,1073,3525,36
2002-09,88,2007,252,232,954,3445,34
2002-10,18,1996,224,214,1013,3447,33
2002-11,70,1997,243,224,988,3452,37
2002-12,92,2014,348,238,839,3439,35
2003-01,8,2085,237,219,905,3446,34
2003-02,106,2084,355,200,814,3453,36
2003-03,64,2048,333,171,808,3360,37
2003-04,22,2028,344,210,781,3363,35
2003-05,52,2021,262,167,931,3381,36
2003-06,22,1964,279,150,984,3377,36
2003-07,100,2043,223,187,952,3405,33
2003-08,20,2027,319,188,899,3433,32
2003-09,54,2009,336,226,811,3382,31
2003-10,76,1985,237,228,940,3390,34
2003-11,70,1996,284,179,961,3420,32
2003-12,72,2054,361,219,835,3469,30
2004-01,70,2097,233,196,970,3496,30
2004-02,60,2108,373,215,803,3499,29
2004-03,60,2023,298,205,896,3422,29
2004-04,46,2049,299,205,889,3442,31
2004-05,70,2093,316,219,849,3477,29
2004-06,112,2108,326,205,819,3458,28
2004-07,88,2146,287,211,836,3480,28
2004-08,110,2097,327,229,858,3511,33
2004-09,86,2023,276,191,981,3471,33
2004-10,52,2060,269,213,944,3486,28
2004-11,58,2078,247,230,944,3499,33
2004-12,38,2087,404,214,821,3526,34
2005-01,100,2059,237,187,1047,3530,37
2005-02,60,2075,305,212,939,3531,34
2005-03,76,2038,251,220,930,3439,34
2005-04,152,1997,241,214,989,3441,35
2005-05,18,2042,285,200,924,3451,33
2005-06,116,2022,363,216,798,3399,37
2005-07,94,1985,342,206,865,3398,35
2005-08,72,2018,330,203,854,3405,30
2005-09,112,1961,244,243,881,3329,32
2005-10,30,1971,242,210,902,3325,34
2005-11,90,1997,271,210,850,3328,31
2005-12,42,1930,377,219,828,3354,36
2006-01,76,1981,317,215,847,3360,33
2006-02,96,2001,297,269,795,3362,31
2006-03,80,1927,325,161,867,3280,36
2006-04,52,1924,325,205,826,3280,35
2006-05,38,1964,233,218,871,3286,35
2006-06,14,1992,439,274,547,3252,35
2006-07,126,1910,289,226,833,3258,37
2006-08,26,1933,270,226,837,3266,35
2006-09,24,1881,274,206,830,3191,33
2006-10,78,1870,355,172,795,3192,36
2006-11,14,1906,221,173,902,3202,33
2006-12,88,1881,251,190,877,3199,35
2007-01,96,1932,331,229,709,3201,35
2007-02,88,1908,291,195,813,3207,34
2007-03,84,1800,271,164,867,3102,38
2007-04,88,1838,237,221,805,3101,31
2007-05,100,1843,249,242,763,3097,39
2007-06,118,1803,246,174,813,3036,34
2007-07,120,1750,227,177,885,3039,37
2007-08,10,1813,277,143,810,3043,32
2007-09,130,1764,238,178,818,2998,34
2007-10,126,1773,238,234,756,3001,33
2007-11,36,1774,379,135,716,3004,32
2007-12,96,1787,217,176,821,3001,34
2008-01,132,1813,199,193,809,3014,33
2008-02,74,1821,288,157,757,3023,32
2008-03,110,1744,260,151,813,2968,33
2008-04,80,1752,354,200,670,2976,29
2008-05,30,1769,261,179,772,2981,32
2008-06,12,1758,250,174,781,2963,31
2008-07,40,1790,282,154,757,2983,33
2008-08,16,1771,240,185,801,2997,30
2008-09,62,1726,228,151,836,2941,32
2008-10,72,1747,206,152,839,2944,33
2008-11,154,1742,205,128,883,2958,38
2008-12,128,1582,260,231,595,2668,37
2009-01,120,1605,298,207,578,2688,38
2009-02,94,1609,273,239,570,2691,38
2009-03,66,1748,227,211,749,2935,37
2009-04,90,1750,268,154,763,2935,37
2009-05,48,1734,307,171,730,2942,37
2009-06,60,1771,225,203,719,2918,32
2009-07,2,1795,256,175,716,2942,33
2009-08,12,1838,315,198,604,2955,33
2009-09,8,1766,282,171,701,2920,36
2009-10,22,1783,242,213,686,2924,37
2009-11,34,1824,262,212,632,2930,37
2009-12,6,1583,298,240,609,2730,34
2010-01,60,1602,252,210,680,2744,33
2010-02,8,1635,259,128,728,2750,32
2010-03,24,1561,247,155,695,2658,39
2010-04,62,1564,196,190,712,2662,35
2010-05,6,1587,335,112,638,2672,34
2010-06,30,1534,191,149,766,2640,35
2010-07,48,1546,332,126,649,2653,36
2010-08,16,1582,294,103,684,2663,32
2010-09,26,1561,264,140,649,2614,33
2010-10,86,1562,196,179,676,2613,30
2010-11,0,1573,369,147,537,2626,30
2010-12,0,1612,308,152,597,2669,37
2011-01,44,1593,236,232,619,2680,35
2011-02,2,1630,292,125,640,2687,33
2011-03,74,1692,218,208,727,2845,38
2011-04,6,1700,185,172,797,2854,35
2011-05,54,1733,327,173,627,2860,36
2011-06,36,1717,293,221,603,2834,34
2011-07,2,1731,350,179,591,2851,34
2011-08,116,1701,231,211,722,2865,33
2011-09,78,1671,275,245,639,2830,35
2011-10,108,1680,299,207,646,2832,34
2011-11,6,1712,293,168,672,2845,35
2011-12,24,1560,213,212,584,2569,32
2012-01,66,1559,213,162,649,2583,33
2012-02,40,1529,198,185,671,2583,36
2012-03,66,1660,292,184,642,2778,38
2012-04,58,1675,230,194,684,2783,33
2012-05,12,1675,258,198,655,2786,32
2012-06,62,1655,267,214,624,2760,34
2012-07,4,1665,247,189,667,2768,37
2012-08,4,1676,311,201,584,2772,34
2012-09,30,1661,290,181,621,2753,36
2012-10,16,1656,357,239,497,2749,35
2012-11,76,1617,303,187,643,2750,37
2012-12,18,1654,325,195,576,2750,38
2013-01,70,1629,393,213,516,2751,35
2013-02,8,1613,298,204,637,2752,32
2013-03,8,1631,226,202,621,2680,33
2013-04,0,1643,245,197,591,2676,34
2013-05,2,1619,213,185,660,2677,30
2013-06,18,1575,278,208,593,2654,29
2013-07,4,1603,239,207,606,2655,33
2013-08,0,1604,177,162,715,2658,33
2013-09,18,1516,215,190,687,2608,32
2013-10,0,1571,294,206,546,2617,32
2013-11,52,1558,269,162,637,2626,28
2013-12,8,1565,290,191,609,2655,29
2014-01,40,1612,307,192,551,2662,29
2014-02,56,1607,334,202,522,2665,32
2014-03,74,1522,245,158,695,2620,35
2014-04,64,1576,264,180,615,2635,30
2014-05,22,1602,217,200,624,2643,32
2014-06,60,1548,324,205,546,2623,33
2014-07,90,1603,312,171,545,2631,30
2014-08,6,1617,303,207,513,2640,31
2014-09,48,1534,255,200,614,2603,32
2014-10,72,1535,224,199,643,2601,35
2014-11,58,1558,262,199,585,2604,38
2014-12,32,1583,224,202,614,2623,35
2015-01,12,1540,237,154,709,2640,37
2015-02,40,1579,259,158,646,2642,32
2015-03,4,1531,251,201,625,2608,34
2015-04,0,1577,336,144,556,2613,32
2015-05,4,1595,185,166,672,2618,35
2015-06,28,1610,406,145,423,2584,27
2015-07,6,1555,254,147,629,2585,29
2015-08,16,1630,255,189,524,2598,34
2015-09,20,1537,228,208,565,2538,33
2015-10,16,1531,280,165,562,2538,34
2015-11,54,1517,310,183,532,2542,30
2015-12,12,1479,262,213,578,2532,33
2016-01,102,1510,324,174,525,2533,30
2016-02,8,1497,252,197,590,2536,30
2016-03,0,1500,244,188,562,2494,31
2016-04,66,1475,244,209,579,2507,29
2016-05,0,1491,304,209,508,2512,32
2016-06,0,1490,297,214,482,2483,29
2016-07,0,1534,214,207,530,2485,29
2016-08,2,1521,281,214,478,2494,28
2016-09,18,1434,205,186,629,2454,35
2016-10,6,1432,194,181,650,2457,36
2016-11,20,1480,267,177,547,2471,36
2016-12,0,1480,231,221,536,2468,34
2017-01,0,1475,280,131,584,2470,33
2017-02,0,1499,301,195,478,2473,36
2017-03,38,1452,259,176,524,2411,30
2017-04,18,1461,275,189,490,2415,34
2017-05,0,1466,218,177,565,2426,35
2017-06,2,1445,275,193,477,2390,31
2017-07,18,1446,255,203,498,2402,33
2017-08,18,1454,269,207,480,2410,31
2017-09,4,1451,304,160,468,2383,30
2017-10,16,1444,250,211,493,2398,35
2017-11,10,1475,319,182,436,2412,30
2017-12,10,1455,208,179,591,2433,33
2018-01,12,1472,213,212,540,2437,32
2018-02,0,1508,208,188,547,2451,31
2018-03,70,1409,220,175,587,2391,34
2018-04,72,1434,235,156,586,2411,29
2018-05,22,1485,219,212,513,2429,31
2018-06,16,1427,207,178,592,2404,34
2018-07,38,1445,225,205,540,2415,34
2018-08,20,1431,192,149,662,2434,35
2018-09,0,1404,208,205,578,2395,32
2018-10,16,1466,211,196,530,2403,34
2018-11,60,1438,192,174,612,2416,32
2018-12,66,1482,219,158,573,2432,33
2019-01,20,1519,217,190,514,2440,34
2019-02,2,1529,255,218,443,2445,31
2019-03,0,1501,249,207,403,2360,31
2019-04,0,1493,246,206,414,2359,32
2019-05,40,1484,241,193,444,2362,34
2019-06,0,1415,233,204,506,2358,34
2019-07,0,1455,290,206,416,2367,31
2019-08,0,1492,207,201,496,2396,33
2019-09,50,1435,231,210,487,2363,35
2019-10,10,1423,208,205,531,2367,34
2019-11,0,1450,313,208,404,2375,31
2019-12,0,1426,242,203,520,2391,33
2020-01,0,1489,327,210,370,2396,28
2020-02,6,1433,239,204,519,2395,29
2020-03,60,1436,216,214,458,2324,28
2020-04,20,1441,207,171,500,2319,32
2020-05,10,1419,263,208,429,2319,32
2020-06,2,1420,268,125,490,2303,32
2020-07,4,1424,288,201,386,2299,29
2020-08,2,1394,207,178,520,2299,33
2020-09,8,1440,208,181,443,2272,30
2020-10,0,1367,197,162,544,2270,33
2020-11,0,1392,216,205,457,2270,28
2020-12,2,1367,178,177,554,2276,31
2021-01,0,1397,262,210,405,2274,31
2021-02,30,1369,205,202,497,2273,29
2021-03,68,1307,190,189,520,2206,30
2021-04,64,1297,198,151,559,2205,34
2021-05,4,1312,217,173,502,2204,32
2021-06,28,1284,201,177,509,2171,33
2021-07,20,1311,235,195,425,2166,32
2021-08,50,1253,215,163,537,2168,33
2021-09,52,1241,194,190,519,2144,31
2021-10,80,1250,214,155,525,2144,31
2021-11,60,1248,231,191,473,2143,31
2021-12,30,1285,202,154,514,2155,29
2022-01,70,1303,279,205,368,2155,31
2022-02,74,1273,201,194,487,2155,31
2022-03,54,1204,189,161,530,2084,37
2022-04,2,1246,248,142,446,2082,31
2022-05,0,1244,199,186,452,2081,33
2022-06,4,1259,211,183,409,2062,31
2022-07,6,1135,191,178,407,1911,29
2022-08,8,1066,188,185,406,1845,29
